1000000000000001
1000000000000001
1000000000000001
1000000000000001
1003000000003001
1001121111211001
1000020000200001
1000020000200001
1000020000200001
1000020000200001
1300020000200031
1112111001112111
1002000000002001
1002000000002001
1002000000002001
1002000000002001
1001112112111001
1000002112000001
1000002112000001
1030002112000301
1111111111111111

