0000000000000000
0000000000000000
0000000000000000
0000000000000000
0000000000000000
0000003000000000
0001111111200000
1000000000200000
1000000000200000
1000000000200000
1003000000203000
1011111121111100
0000000020000000
0000000020000000
0000000020000000
0000000020000000
0000000020000000
0000002111111201
0000002110000201
0000302110300201
1111111111111111