0000000000000000
0000000000300000
0001112111111000
0000002000000000
0000002000000000
0000302000000000
0011111112000000
0000000002000000
0000000002000000
0000000002000000
0000003002000000
1122111111110000
0022000000000000
0022000000000000
0022000000003000
0022000002111111
0022000002000000
0022000002000000
0022000002000000
0022003002003000
1111111111111111