0000000000000000
0000000000000000
0000000000000000
0000000000000000
0000000000000000
0000003003000000
0011211111121100
0000200000020000
0000200000020000
0000200000020000
0030200000020300
0111112002111110
0000002002000000
0000002002000000
0000002002000000
0300002002000030
1111211111121111
0000200000020000
0000200000020000
0000200000020000
1111111111111111
